4 1 1 1 1 1 1 5 1 1 1 1 1 1 1 1 5 1 1 1 1 1 1 1 1 1 1 5 1 1 1 1 1 1 1 1 1 1 5 1 1 1 1 1 1 1 1 1 1 1 
4 0 0 0 0 0 8 4 0 0 0 0 0 0 0 8 4 0 0 0 0 0 0 0 0 0 8 4 0 0 0 0 0 0 0 0 0 8 4 0 0 0 0 0 0 0 0 0 0 8 
4 0 0 0 0 0 8 4 0 0 0 0 0 0 0 8 4 0 0 0 0 0 0 0 0 0 8 4 0 0 0 0 0 0 0 0 0 8 4 0 0 0 0 0 0 0 0 0 0 8 
4 0 0 0 0 0 8 4 0 0 0 0 0 0 0 8 4 0 0 0 0 0 0 0 0 0 8 4 0 0 0 0 0 0 0 0 0 8 4 0 0 0 0 0 0 0 0 0 0 8 
4 0 0 0 0 0 8 4 0 0 0 0 0 0 0 8 4 0 0 0 0 0 0 0 0 0 8 4 0 0 0 0 0 0 0 0 0 8 4 0 0 0 0 0 0 0 0 0 0 8 
4 0 0 0 0 0 8 4 0 0 0 0 0 0 0 8 4 0 0 0 0 0 0 0 0 0 8 4 0 0 0 0 0 0 0 0 0 8 4 0 0 0 0 0 0 0 0 0 0 8 
6 2 2 2 2 2 10 6 2 2 2 2 2 2 2 10 6 2 2 2 2 2 2 2 2 2 10 6 2 2 2 2 2 2 2 2 2 10 6 2 2 2 2 2 2 2 2 2 2 8 
4 1 1 1 1 1 9 9 1 1 1 1 1 1 1 9 9 1 1 1 1 1 1 1 1 1 9 9 1 1 1 1 1 1 1 1 1 9 9 1 1 1 1 1 1 1 1 1 1 9 
4 0 0 0 0 0 8 4 0 0 0 0 0 0 0 8 4 0 0 0 0 0 0 0 0 0 8 4 0 0 0 0 0 0 0 0 0 8 4 0 0 0 0 0 0 0 0 0 0 8 
4 0 0 0 0 0 8 4 0 0 0 0 0 0 0 8 4 0 0 0 0 0 0 0 0 0 8 4 0 0 0 0 0 0 0 0 0 8 4 0 0 0 0 0 0 0 0 0 0 8 
4 0 0 0 0 0 8 4 0 0 0 0 0 0 0 8 4 0 0 0 0 0 0 0 0 0 8 4 0 0 0 0 0 0 0 0 0 8 4 0 0 0 0 0 0 0 0 0 0 8 
4 0 0 0 0 0 8 4 0 0 0 0 0 0 0 8 4 0 0 0 0 0 0 0 0 0 8 4 0 0 0 0 0 0 0 0 0 8 4 0 0 0 0 0 0 0 0 0 0 8 
4 0 0 0 0 0 8 4 0 0 0 0 0 0 0 8 4 0 0 0 0 0 0 0 0 0 8 4 0 0 0 0 0 0 0 0 0 8 4 0 0 0 0 0 0 0 0 0 0 8 
4 0 0 0 0 0 8 4 0 0 0 0 0 0 0 8 4 0 0 0 0 0 0 0 0 0 8 4 0 0 0 0 0 0 0 0 0 8 4 0 0 0 0 0 0 0 0 0 0 8 
6 2 2 2 2 2 10 6 2 2 2 2 2 2 2 10 6 2 2 2 2 2 2 2 2 2 10 6 2 2 2 2 2 2 2 2 2 10 6 2 2 2 2 2 2 2 2 2 2 8 
4 1 1 1 1 1 9 9 1 1 1 1 1 1 1 9 9 1 1 1 1 1 1 1 1 1 9 9 1 1 1 1 1 1 1 1 1 9 9 1 1 1 1 1 1 1 1 1 1 9 
4 0 0 0 0 0 8 4 0 0 0 0 0 0 0 8 4 0 0 0 0 0 0 0 0 0 8 4 0 0 0 0 0 0 0 0 0 8 4 0 0 0 0 0 0 0 0 0 0 8 
4 0 0 0 0 0 8 4 0 0 0 0 0 0 0 8 4 0 0 0 0 0 0 0 0 0 8 4 0 0 0 0 0 0 0 0 0 8 4 0 0 0 0 0 0 0 0 0 0 8 
4 0 0 0 0 0 8 4 0 0 0 0 0 0 0 8 4 0 0 0 0 0 0 0 0 0 8 4 0 0 0 0 0 0 0 0 0 8 4 0 0 0 0 0 0 0 0 0 0 8 
4 0 0 0 0 0 8 4 0 0 0 0 0 0 0 8 4 0 0 0 0 0 0 0 0 0 8 4 0 0 0 0 0 0 0 0 0 8 4 0 0 0 0 0 0 0 0 0 0 8 
4 0 0 0 0 0 8 4 0 0 0 0 0 0 0 8 4 0 0 0 0 0 0 0 0 0 8 4 0 0 0 0 0 0 0 0 0 8 4 0 0 0 0 0 0 0 0 0 0 8 
6 2 2 2 2 2 10 6 2 2 2 2 2 2 2 10 6 2 2 2 2 2 2 2 2 2 10 6 2 2 2 2 2 2 2 2 2 10 6 2 2 2 2 2 2 2 2 2 2 8 
4 1 1 1 1 1 9 9 1 1 1 1 1 1 1 9 9 1 1 1 1 1 1 1 1 1 9 9 1 1 1 1 1 1 1 1 1 9 9 1 1 1 1 1 1 1 1 1 1 9 
4 0 0 0 0 0 8 4 0 0 0 0 0 0 0 8 4 0 0 0 0 0 0 0 0 0 8 4 0 0 0 0 0 0 0 0 0 8 4 0 0 0 0 0 0 0 0 0 0 8 
4 0 0 0 0 0 8 4 0 0 0 0 0 0 0 8 4 0 0 0 0 0 0 0 0 0 8 4 0 0 0 0 0 0 0 0 0 8 4 0 0 0 0 0 0 0 0 0 0 8 
4 0 0 0 0 0 8 4 0 0 0 0 0 0 0 8 4 0 0 0 0 0 0 0 0 0 8 4 0 0 0 0 0 0 0 0 0 8 4 0 0 0 0 0 0 0 0 0 0 8 
4 0 0 0 0 0 8 4 0 0 0 0 0 0 0 8 4 0 0 0 0 0 0 0 0 0 8 4 0 0 0 0 0 0 0 0 0 8 4 0 0 0 0 0 0 0 0 0 0 8 
4 0 0 0 0 0 8 4 0 0 0 0 0 0 0 8 4 0 0 0 0 0 0 0 0 0 8 4 0 0 0 0 0 0 0 0 0 8 4 0 0 0 0 0 0 0 0 0 0 8 
6 2 2 2 2 2 10 6 2 2 2 2 2 2 2 10 6 2 2 2 2 2 2 2 2 2 10 6 2 2 2 2 2 2 2 2 2 10 6 2 2 2 2 2 2 2 2 2 2 8 
4 1 1 1 1 1 9 9 1 1 1 1 1 1 1 9 9 1 1 1 1 1 1 1 1 1 9 9 1 1 1 1 1 1 1 1 1 9 9 1 1 1 1 1 1 1 1 1 1 9 
4 0 0 0 0 0 8 4 0 0 0 0 0 0 0 8 4 0 0 0 0 0 0 0 0 0 8 4 0 0 0 0 0 0 0 0 0 8 4 0 0 0 0 0 0 0 0 0 0 8 
4 0 0 0 0 0 8 4 0 0 0 0 0 0 0 8 4 0 0 0 0 0 0 0 0 0 8 4 0 0 0 0 0 0 0 0 0 8 4 0 0 0 0 0 0 0 0 0 0 8 
4 0 0 0 0 0 8 4 0 0 0 0 0 0 0 8 4 0 0 0 0 0 0 0 0 0 8 4 0 0 0 0 0 0 0 0 0 8 4 0 0 0 0 0 0 0 0 0 0 8 
4 0 0 0 0 0 8 4 0 0 0 0 0 0 0 8 4 0 0 0 0 0 0 0 0 0 8 4 0 0 0 0 0 0 0 0 0 8 4 0 0 0 0 0 0 0 0 0 0 8 
4 0 0 0 0 0 8 4 0 0 0 0 0 0 0 8 4 0 0 0 0 0 0 0 0 0 8 4 0 0 0 0 0 0 0 0 0 8 4 0 0 0 0 0 0 0 0 0 0 8 
6 2 2 2 2 2 10 6 2 2 2 2 2 2 2 10 6 2 2 2 2 2 2 2 2 2 10 6 2 2 2 2 2 2 2 2 2 10 6 2 2 2 2 2 2 2 2 2 2 8 
4 1 1 1 1 1 9 9 1 1 1 1 1 1 1 9 9 1 1 1 1 1 1 1 1 1 9 9 1 1 1 1 1 1 1 1 1 9 9 1 1 1 1 1 1 1 1 1 1 9 
4 0 0 0 0 0 8 4 0 0 0 0 0 0 0 8 4 0 0 0 0 0 0 0 0 0 8 4 0 0 0 0 0 0 0 0 0 8 4 0 0 0 0 0 0 0 0 0 0 8 
4 0 0 0 0 0 8 4 0 0 0 0 0 0 0 8 4 0 0 0 0 0 0 0 0 0 8 4 0 0 0 0 0 0 0 0 0 8 4 0 0 0 0 0 0 0 0 0 0 8 
4 0 0 0 0 0 8 4 0 0 0 0 0 0 0 8 4 0 0 0 0 0 0 0 0 0 8 4 0 0 0 0 0 0 0 0 0 8 4 0 0 0 0 0 0 0 0 0 0 8 
4 0 0 0 0 0 8 4 0 0 0 0 0 0 0 8 4 0 0 0 0 0 0 0 0 0 8 4 0 0 0 0 0 0 0 0 0 8 4 0 0 0 0 0 0 0 0 0 0 8 
4 0 0 0 0 0 8 4 0 0 0 0 0 0 0 8 4 0 0 0 0 0 0 0 0 0 8 4 0 0 0 0 0 0 0 0 0 8 4 0 0 0 0 0 0 0 0 0 0 8 
4 0 0 0 0 0 8 4 0 0 0 0 0 0 0 8 4 0 0 0 0 0 0 0 0 0 8 4 0 0 0 0 0 0 0 0 0 8 4 0 0 0 0 0 0 0 0 0 0 8 
6 2 2 2 2 2 10 6 2 2 2 2 2 2 2 10 6 2 2 2 2 2 2 2 2 2 10 6 2 2 2 2 2 2 2 2 2 10 6 2 2 2 2 2 2 2 2 2 2 8 
4 1 1 1 1 1 9 9 1 1 1 1 1 1 1 9 9 1 1 1 1 1 1 1 1 1 9 9 1 1 1 1 1 1 1 1 1 9 9 1 1 1 1 1 1 1 1 1 1 9 
4 0 0 0 0 0 8 4 0 0 0 0 0 0 0 8 4 0 0 0 0 0 0 0 0 0 8 4 0 0 0 0 0 0 0 0 0 8 4 0 0 0 0 0 0 0 0 0 0 8 
4 0 0 0 0 0 8 4 0 0 0 0 0 0 0 8 4 0 0 0 0 0 0 0 0 0 8 4 0 0 0 0 0 0 0 0 0 8 4 0 0 0 0 0 0 0 0 0 0 8 
4 0 0 0 0 0 8 4 0 0 0 0 0 0 0 8 4 0 0 0 0 0 0 0 0 0 8 4 0 0 0 0 0 0 0 0 0 8 4 0 0 0 0 0 0 0 0 0 0 8 
4 0 0 0 0 0 8 4 0 0 0 0 0 0 0 8 4 0 0 0 0 0 0 0 0 0 8 4 0 0 0 0 0 0 0 0 0 8 4 0 0 0 0 0 0 0 0 0 0 8 
2 2 2 2 2 2 10 2 2 2 2 2 2 2 2 10 2 2 2 2 2 2 2 2 2 2 10 2 2 2 2 2 2 2 2 2 2 10 4 2 2 2 2 2 2 2 2 2 2 8 
